"aG" = (/obj/machinery/door/blast/regular{name = "Security Blast Door"; icon_state = "pdoor0"; opacity = 0; density = 0; id = "Prison Gate"},/obj/effect/landmark/start/crew/mime,/turf/simulated/floor/shuttle/yellow,/area/shuttle/ferry/outpost/centcomm17)
"aL" = (/obj/effect/floor_decal/stairs,/obj/machinery/door/blast/regular{name = "Security Blast Door"; icon_state = "pdoor0"; opacity = 0; density = 0; id = "Prison Gate"},/obj/structure/disposalpipe/segment,/obj/effect/landmark/joinlate/observer,/turf/simulated/floor/tiled/mono,/area/shuttle/ferry/outpost/centcomm17)
"bC" = (/turf/unsimulated/wall{icon_state = "riveted_l"},/area/shuttle/ferry/outpost/centcomm17)
"bI" = (/obj/machinery/light,/obj/structure/disposalpipe/segment{icon_state = "pipe-c"; dir = 2},/turf/simulated/floor/tiled/rough,/area/shuttle/ferry/outpost/centcomm17)
"bL" = (/turf/simulated/shuttle/wall{icon_state = "whiteship"},/area/shuttle/ferry/outpost/centcomm17)
"bW" = (/obj/structure/extinguisher_cabinet{pixel_x = 32},/turf/simulated/floor/tiled/freezer,/area/shuttle/ferry/outpost/centcomm17)
"cc" = (/turf/unsimulated/wall{icon_state = "riveted_t"; dir = 8},/area/shuttle/ferry/outpost/centcomm17)
"cu" = (/obj/structure/table/reinforced,/obj/effect/floor_decal/corner/lime{dir = 9},/obj/machinery/light,/turf/simulated/floor/tiled/rough,/area/shuttle/ferry/outpost/centcomm17)
"cW" = (/obj/structure/bed/chair{dir = 8},/turf/simulated/floor/tiled/mono,/area/shuttle/ferry/outpost/centcomm17)
"cY" = (/turf/simulated/floor/tiled/mono,/area/shuttle/ferry/outpost/centcomm17)
"db" = (/obj/structure/urinal{pixel_y = 32},/turf/simulated/floor/tiled/freezer,/area/shuttle/ferry/outpost/centcomm17)
"dt" = (/obj/structure/closet/emcloset/legacy,/obj/effect/floor_decal/corner/lime{dir = 9},/turf/simulated/floor/tiled/rough,/area/shuttle/ferry/outpost/centcomm17)
"du" = (/turf/unsimulated/wall{icon_state = "riveted"; dir = 1},/area/shuttle/ferry/outpost/centcomm17)
"dX" = (/obj/machinery/door/airlock/glass,/turf/simulated/floor/shuttle/yellow,/area/shuttle/ferry/outpost/centcomm17)
"el" = (/obj/structure/table/reinforced,/obj/effect/floor_decal/corner/lime{dir = 6},/turf/simulated/floor/tiled/rough,/area/shuttle/ferry/outpost/centcomm17)
"eR" = (/turf/unsimulated/wall{icon_state = "riveted_t"; dir = 1},/area/shuttle/ferry/outpost/centcomm17)
"eS" = (/turf/template_noop,/area/template_noop)
"ff" = (/obj/structure/bed/chair{icon_state = "chair_preview"; dir = 1},/obj/effect/landmark/start/crew/qm,/turf/simulated/floor/shuttle/yellow,/area/shuttle/ferry/outpost/centcomm17)
"fl" = (/obj/machinery/door/blast/regular{name = "Security Blast Door"; icon_state = "pdoor0"; opacity = 0; density = 0; id = "Prison Gate"},/obj/effect/landmark/start/crew/roboticist,/turf/simulated/floor/shuttle/yellow,/area/shuttle/ferry/outpost/centcomm17)
"hK" = (/obj/effect/landmark/start/crew/doctor,/turf/simulated/floor/shuttle/yellow,/area/shuttle/ferry/outpost/centcomm17)
"hO" = (/turf/unsimulated/wall{icon_state = "riveted_t"; dir = 4},/area/shuttle/ferry/outpost/centcomm17)
"hR" = (/obj/structure/window/reinforced{dir = 4},/obj/structure/flora/ausbushes/ywflowers,/turf/simulated/floor/natural/grass{name = "artificial grass patch"},/area/shuttle/ferry/outpost/centcomm17)
"if" = (/turf/simulated/floor/plating/rough,/turf/simulated/shuttle/wall/corner/smoothwhite/se,/area/shuttle/ferry/outpost/centcomm17)
"iP" = (/obj/effect/floor_decal/stairs{dir = 4},/obj/machinery/light,/turf/simulated/floor/tiled/mono,/area/shuttle/ferry/outpost/centcomm17)
"ju" = (/obj/structure/bed/chair/office/dark{dir = 4},/turf/simulated/floor/tiled/rough,/area/shuttle/ferry/outpost/centcomm17)
"jB" = (/turf/simulated/floor/plating/rough,/turf/simulated/shuttle/wall/corner/smoothwhite/ne,/area/shuttle/ferry/outpost/centcomm17)
"jR" = (/obj/structure/bed/chair{icon_state = "chair_preview"; dir = 1},/obj/effect/landmark/start/crew/bartender,/obj/effect/landmark/start/crew/barmonkey,/turf/simulated/floor/shuttle/yellow,/area/shuttle/ferry/outpost/centcomm17)
"kf" = (/obj/machinery/light{icon_state = "tube1"; dir = 1},/turf/simulated/floor/tiled/rough,/area/shuttle/ferry/outpost/centcomm17)
"kk" = (/obj/machinery/door/airlock{name = "Unit 1"},/turf/simulated/floor/tiled/freezer,/area/shuttle/ferry/outpost/centcomm17)
"kB" = (/obj/effect/landmark/start/crew/iaa,/turf/simulated/floor/shuttle/yellow,/area/shuttle/ferry/outpost/centcomm17)
"la" = (/turf/simulated/floor/plating/rough,/turf/simulated/shuttle/wall/corner/smoothwhite/sw,/area/shuttle/ferry/outpost/centcomm17)
"lc" = (/obj/structure/disposalpipe/segment{dir = 4},/obj/machinery/vending/coffee,/turf/simulated/floor/tiled/rough,/area/shuttle/ferry/outpost/centcomm17)
"lz" = (/obj/structure/bed/chair{icon_state = "chair_preview"; dir = 1},/obj/effect/landmark/start/crew/gartender,/turf/simulated/floor/shuttle/yellow,/area/shuttle/ferry/outpost/centcomm17)
"lD" = (/obj/machinery/door/blast/regular{name = "Security Blast Door"; icon_state = "pdoor0"; opacity = 0; density = 0; id = "Prison Gate"},/obj/effect/landmark/start/crew/scientist,/turf/simulated/floor/shuttle/yellow,/area/shuttle/ferry/outpost/centcomm17)
"lI" = (/turf/unsimulated/wall{icon_state = "riveted_straight"},/area/shuttle/ferry/outpost/centcomm17)
"lM" = (/obj/machinery/door/blast/regular{name = "Security Blast Door"; icon_state = "pdoor0"; opacity = 0; density = 0; id = "Prison Gate"},/turf/simulated/floor/shuttle/yellow,/area/shuttle/ferry/outpost/centcomm17)
"md" = (/turf/unsimulated/wall{icon_state = "riveted"; dir = 8},/area/shuttle/ferry/outpost/centcomm17)
"mG" = (/obj/structure/disposalpipe/segment{dir = 4},/obj/machinery/vending/cola,/turf/simulated/floor/tiled/rough,/area/shuttle/ferry/outpost/centcomm17)
"na" = (/obj/effect/landmark/joinlate/cyborg,/turf/simulated/floor/tiled/mono,/area/shuttle/ferry/outpost/centcomm17)
"nw" = (/obj/effect/floor_decal/stairs{dir = 8},/turf/simulated/floor/tiled/mono,/area/shuttle/ferry/outpost/centcomm17)
"nM" = (/obj/effect/floor_decal/industrial/warning{dir = 1},/obj/machinery/door/airlock/autoname,/turf/simulated/floor/tiled/mono,/area/shuttle/ferry/outpost/centcomm17)
"nQ" = (/obj/machinery/door/airlock{name = "Unisex Restrooms"},/turf/unsimulated/wall,/area/shuttle/ferry/outpost/centcomm17)
"nX" = (/obj/structure/bed/chair{icon_state = "chair_preview"; dir = 1},/obj/effect/landmark/start/crew/chaplain,/turf/simulated/floor/shuttle/yellow,/area/shuttle/ferry/outpost/centcomm17)
"od" = (/obj/structure/bed/chair{icon_state = "chair_preview"; dir = 1},/obj/effect/landmark/start/crew/paramedic,/turf/simulated/floor/shuttle/yellow,/area/shuttle/ferry/outpost/centcomm17)
"oe" = (/obj/structure/bed/chair{icon_state = "chair_preview"; dir = 1},/obj/effect/landmark/start/crew/hop,/turf/simulated/floor/shuttle/yellow,/area/shuttle/ferry/outpost/centcomm17)
"oZ" = (/obj/machinery/door/blast/regular{dir = 4},/turf/space,/area/shuttle/ferry/outpost/centcomm17)
"pk" = (/obj/effect/floor_decal/stairs{dir = 4},/turf/simulated/floor/tiled/mono,/area/shuttle/ferry/outpost/centcomm17)
"pB" = (/obj/structure/disposalpipe/segment{dir = 4},/turf/simulated/floor/tiled/rough,/area/shuttle/ferry/outpost/centcomm17)
"pG" = (/obj/effect/landmark/start/crew/janitor,/turf/simulated/floor/shuttle/yellow,/area/shuttle/ferry/outpost/centcomm17)
"pI" = (/obj/effect/floor_decal/stairs,/obj/machinery/door/blast/regular{name = "Security Blast Door"; icon_state = "pdoor0"; opacity = 0; density = 0; id = "Prison Gate"},/turf/simulated/floor/tiled/mono,/area/shuttle/ferry/outpost/centcomm17)
"pP" = (/obj/structure/bed/chair{icon_state = "chair_preview"; dir = 1},/obj/effect/landmark/start/crew/officer,/turf/simulated/floor/shuttle/yellow,/area/shuttle/ferry/outpost/centcomm17)
"pR" = (/obj/machinery/door/airlock/external{name = "Arrivals Airlock"; icon_state = "door_locked"; frequency = 1380; locked = 1; req_access = list(13); id_tag = "centcom_dock_airlock"},/obj/effect/shuttle_landmark/outpost/starting,/turf/simulated/floor/tiled/rough,/area/shuttle/ferry/outpost/centcomm17)
"qc" = (/obj/machinery/door/blast/regular{name = "Security Blast Door"; icon_state = "pdoor0"; opacity = 0; density = 0; id = "Prison Gate"},/obj/effect/landmark/start/crew/lawyer,/turf/simulated/floor/shuttle/yellow,/area/shuttle/ferry/outpost/centcomm17)
"qx" = (/obj/structure/disposalpipe/segment{dir = 4},/obj/machinery/vending/snack,/turf/simulated/floor/tiled/rough,/area/shuttle/ferry/outpost/centcomm17)
"qE" = (/obj/structure/sink{pixel_y = -12},/obj/structure/mirror{pixel_y = -32},/turf/simulated/floor/tiled/freezer,/area/shuttle/ferry/outpost/centcomm17)
"qF" = (/obj/effect/floor_decal/corner/red{dir = 9},/turf/simulated/floor/tiled/rough,/area/shuttle/ferry/outpost/centcomm17)
"qO" = (/obj/structure/window/reinforced{dir = 8; health = 1e+06},/obj/structure/flora/ausbushes/brflowers,/turf/simulated/floor/natural/grass{name = "artificial grass patch"},/area/shuttle/ferry/outpost/centcomm17)
"qT" = (/obj/structure/bed/chair{icon_state = "chair_preview"; dir = 1},/obj/effect/landmark/start/crew/cargotech,/turf/simulated/floor/shuttle/yellow,/area/shuttle/ferry/outpost/centcomm17)
"rG" = (/obj/structure/table/reinforced,/obj/machinery/door/window/brigdoor/southright{dir = 8},/turf/simulated/floor/tiled/rough,/area/shuttle/ferry/outpost/centcomm17)
"rI" = (/obj/structure/bed/chair{icon_state = "chair_preview"; dir = 1},/obj/effect/landmark/start/crew/engineer,/turf/simulated/floor/shuttle/yellow,/area/shuttle/ferry/outpost/centcomm17)
"sU" = (/obj/effect/landmark/joinlate,/turf/simulated/floor/tiled/mono,/area/shuttle/ferry/outpost/centcomm17)
"tl" = (/obj/effect/landmark/start/crew/captain,/turf/simulated/floor/shuttle/yellow,/area/shuttle/ferry/outpost/centcomm17)
"uk" = (/obj/structure/bed/chair{icon_state = "chair_preview"; dir = 1},/obj/effect/landmark/start/crew/chemist,/turf/simulated/floor/shuttle/yellow,/area/shuttle/ferry/outpost/centcomm17)
"uB" = (/obj/effect/landmark/start/crew/cmo,/turf/simulated/floor/shuttle/yellow,/area/shuttle/ferry/outpost/centcomm17)
"uX" = (/obj/effect/floor_decal/corner/lime{dir = 6},/turf/simulated/floor/tiled/rough,/area/shuttle/ferry/outpost/centcomm17)
"vf" = (/obj/structure/toilet{dir = 8},/obj/machinery/light/small{dir = 4},/obj/machinery/newscaster{layer = 3.3; pixel_y = -27},/obj/effect/landmark/start/crew/lawyer,/turf/simulated/floor/tiled/freezer,/area/shuttle/ferry/outpost/centcomm17)
"vl" = (/obj/effect/landmark/start/crew/psyhiatrist,/turf/simulated/floor/shuttle/yellow,/area/shuttle/ferry/outpost/centcomm17)
"vK" = (/obj/structure/closet/emcloset/legacy,/obj/effect/floor_decal/corner/lime{dir = 6},/turf/simulated/floor/tiled/rough,/area/shuttle/ferry/outpost/centcomm17)
"vV" = (/obj/machinery/door/blast/regular{name = "Security Blast Door"; icon_state = "pdoor0"; opacity = 0; density = 0; id = "Prison Gate"},/turf/simulated/floor/tiled/rough,/area/shuttle/ferry/outpost/centcomm17)
"wu" = (/obj/effect/floor_decal/corner/red{dir = 5},/obj/effect/landmark/start/crew/cargotech,/turf/simulated/floor/tiled/rough,/area/shuttle/ferry/outpost/centcomm17)
"wx" = (/turf/simulated/shuttle/wall{icon_state = "whiteship"; dir = 4},/area/shuttle/ferry/outpost/centcomm17)
"wE" = (/turf/simulated/floor/tiled/freezer,/area/shuttle/ferry/outpost/centcomm17)
"xM" = (/obj/machinery/door/blast/regular{name = "Security Blast Door"; icon_state = "pdoor0"; opacity = 0; density = 0; id = "Prison Gate"},/obj/structure/disposalpipe/junction,/turf/simulated/floor/tiled/rough,/area/shuttle/ferry/outpost/centcomm17)
"xY" = (/obj/machinery/light{icon_state = "tube1"; dir = 1},/obj/machinery/embedded_controller/radio/simple_docking_controller{name = "docking port controller"; frequency = 1380; req_one_access = list(13); id_tag = "centcom_dock"; tag_door = "centcom_dock_airlock"; pixel_y = 25},/turf/simulated/floor/tiled/rough,/area/shuttle/ferry/outpost/centcomm17)
"yA" = (/obj/structure/window/reinforced{dir = 8; health = 1e+06},/obj/structure/flora/ausbushes/ywflowers,/turf/simulated/floor/natural/grass{name = "artificial grass patch"},/area/shuttle/ferry/outpost/centcomm17)
"yB" = (/obj/machinery/light{dir = 1},/turf/simulated/floor/tiled/mono,/area/shuttle/ferry/outpost/centcomm17)
"zl" = (/obj/effect/floor_decal/industrial/warning,/obj/effect/landmark/start/crew/xenobiologist,/turf/simulated/floor/tiled/mono,/area/shuttle/ferry/outpost/centcomm17)
"zC" = (/obj/structure/bed/chair{icon_state = "chair_preview"; dir = 1},/obj/effect/landmark/start/crew/cyborg,/turf/simulated/floor/shuttle/yellow,/area/shuttle/ferry/outpost/centcomm17)
"zK" = (/obj/structure/bed/chair{icon_state = "chair_preview"; dir = 1},/obj/effect/landmark/start/crew/clown,/turf/simulated/floor/shuttle/yellow,/area/shuttle/ferry/outpost/centcomm17)
"zW" = (/obj/effect/floor_decal/industrial/warning,/obj/effect/landmark/start/crew/officer,/turf/simulated/floor/tiled/mono,/area/shuttle/ferry/outpost/centcomm17)
"An" = (/obj/effect/landmark/start/crew/chef,/turf/simulated/floor/shuttle/yellow,/area/shuttle/ferry/outpost/centcomm17)
"Ar" = (/obj/effect/floor_decal/industrial/warning{dir = 1},/turf/simulated/floor/tiled/mono,/area/shuttle/ferry/outpost/centcomm17)
"AZ" = (/obj/effect/floor_decal/corner/red{dir = 5},/turf/simulated/floor/tiled/rough,/area/shuttle/ferry/outpost/centcomm17)
"Ba" = (/obj/effect/floor_decal/corner/red{dir = 6},/turf/simulated/floor/tiled/rough,/area/shuttle/ferry/outpost/centcomm17)
"BC" = (/obj/structure/table/reinforced,/obj/effect/floor_decal/corner/lime{dir = 6},/obj/structure/sign/poster{pixel_y = 32},/turf/simulated/floor/tiled/rough,/area/shuttle/ferry/outpost/centcomm17)
"BE" = (/obj/machinery/light{icon_state = "tube1"; dir = 4},/turf/simulated/floor/tiled/rough,/area/shuttle/ferry/outpost/centcomm17)
"BY" = (/obj/structure/table/reinforced,/obj/effect/floor_decal/corner/lime{dir = 9},/turf/simulated/floor/tiled/rough,/area/shuttle/ferry/outpost/centcomm17)
"Cf" = (/obj/structure/table/reinforced,/obj/structure/window/reinforced{dir = 8; health = 1e+06},/obj/item/material/ashtray/plastic,/obj/item/device/taperecorder{pixel_x = 4; pixel_y = 2},/obj/item/paper_bin{pixel_y = 5},/obj/item/pen/blue{pixel_x = -5; pixel_y = -1},/turf/simulated/floor/tiled/rough,/area/shuttle/ferry/outpost/centcomm17)
"Ci" = (/obj/effect/floor_decal/corner/lime{dir = 6},/obj/structure/closet/emcloset/legacy,/turf/simulated/floor/tiled/rough,/area/shuttle/ferry/outpost/centcomm17)
"Ck" = (/obj/machinery/disposal,/obj/structure/disposalpipe/trunk{dir = 4},/turf/simulated/floor/tiled/rough,/area/shuttle/ferry/outpost/centcomm17)
"Cv" = (/obj/structure/table/reinforced,/obj/machinery/door/window/brigdoor/southright{dir = 4},/turf/simulated/floor/tiled/rough,/area/shuttle/ferry/outpost/centcomm17)
"CA" = (/obj/effect/landmark/start/crew/hos,/turf/simulated/floor/shuttle/yellow,/area/shuttle/ferry/outpost/centcomm17)
"DH" = (/obj/effect/landmark/start/crew/ce,/turf/simulated/floor/shuttle/yellow,/area/shuttle/ferry/outpost/centcomm17)
"DN" = (/obj/effect/floor_decal/corner/lime{dir = 6},/obj/machinery/light{dir = 4},/turf/simulated/floor/tiled/rough,/area/shuttle/ferry/outpost/centcomm17)
"Ee" = (/obj/machinery/light,/obj/structure/disposalpipe/segment{dir = 4},/turf/simulated/floor/tiled/rough,/area/shuttle/ferry/outpost/centcomm17)
"Ej" = (/turf/unsimulated/wall{icon_state = "riveted"; dir = 4},/area/shuttle/ferry/outpost/centcomm17)
"Ey" = (/obj/structure/window/reinforced{dir = 8; health = 1e+06},/obj/structure/flora/ausbushes/ppflowers,/turf/simulated/floor/natural/grass{name = "artificial grass patch"},/area/shuttle/ferry/outpost/centcomm17)
"EY" = (/obj/effect/floor_decal/corner/lime{dir = 9},/obj/machinery/light{dir = 8},/turf/simulated/floor/tiled/rough,/area/shuttle/ferry/outpost/centcomm17)
"Fc" = (/obj/structure/bed/chair{icon_state = "chair_preview"; dir = 1},/obj/effect/landmark/start/crew/miner,/turf/simulated/floor/shuttle/yellow,/area/shuttle/ferry/outpost/centcomm17)
"GJ" = (/obj/structure/disposalpipe/segment{icon_state = "pipe-c"; dir = 4},/turf/simulated/floor/tiled/rough,/area/shuttle/ferry/outpost/centcomm17)
"GR" = (/obj/machinery/door/airlock/command,/turf/simulated/floor/tiled/rough,/area/shuttle/ferry/outpost/centcomm17)
"GU" = (/obj/structure/disposalpipe/segment,/turf/simulated/floor/tiled/mono,/area/shuttle/ferry/outpost/centcomm17)
"Hd" = (/obj/effect/landmark/joinlate/gate,/turf/simulated/floor/tiled/mono,/area/shuttle/ferry/outpost/centcomm17)
"Hp" = (/obj/structure/sign/poster{pixel_y = 32},/turf/simulated/floor/tiled/freezer,/area/shuttle/ferry/outpost/centcomm17)
"Hs" = (/obj/machinery/photocopier,/turf/simulated/floor/tiled/rough,/area/shuttle/ferry/outpost/centcomm17)
"HB" = (/obj/structure/flora/pottedplant/orientaltree,/turf/simulated/floor/tiled/rough,/area/shuttle/ferry/outpost/centcomm17)
"Ii" = (/obj/effect/floor_decal/stairs{dir = 8},/obj/machinery/light,/turf/simulated/floor/tiled/mono,/area/shuttle/ferry/outpost/centcomm17)
"Im" = (/obj/effect/floor_decal/industrial/warning,/obj/effect/landmark/start/crew/warden,/turf/simulated/floor/tiled/mono,/area/shuttle/ferry/outpost/centcomm17)
"Iw" = (/obj/machinery/light{dir = 8},/turf/simulated/floor/tiled/rough,/area/shuttle/ferry/outpost/centcomm17)
"IQ" = (/obj/structure/disposalpipe/segment,/obj/effect/landmark/start/crew/paramedic,/turf/simulated/floor/tiled/mono,/area/shuttle/ferry/outpost/centcomm17)
"Jp" = (/obj/machinery/door/airlock{name = "Unit 3"},/turf/simulated/floor/tiled/freezer,/area/shuttle/ferry/outpost/centcomm17)
"JR" = (/obj/structure/bed/chair,/turf/simulated/floor/tiled/rough,/area/shuttle/ferry/outpost/centcomm17)
"Km" = (/obj/effect/landmark/joinlate/cryo,/turf/simulated/floor/tiled/mono,/area/shuttle/ferry/outpost/centcomm17)
"KD" = (/obj/machinery/door/blast/regular{name = "Security Blast Door"; icon_state = "pdoor0"; opacity = 0; density = 0; id = "Prison Gate"},/obj/effect/landmark/start/crew/librarian,/turf/simulated/floor/shuttle/yellow,/area/shuttle/ferry/outpost/centcomm17)
"KJ" = (/obj/effect/landmark/start/crew/assistant,/turf/simulated/floor/shuttle/yellow,/area/shuttle/ferry/outpost/centcomm17)
"Ld" = (/turf/unsimulated/wall{icon_state = "riveted_c"; dir = 1},/area/shuttle/ferry/outpost/centcomm17)
"Lj" = (/turf/simulated/floor/tiled/rough,/area/shuttle/ferry/outpost/centcomm17)
"LF" = (/obj/structure/window/reinforced{dir = 4},/obj/structure/flora/ausbushes/leafybush,/turf/simulated/floor/natural/grass{name = "artificial grass patch"},/area/shuttle/ferry/outpost/centcomm17)
"LJ" = (/obj/structure/bed/chair/office/dark{dir = 8},/turf/simulated/floor/tiled/rough,/area/shuttle/ferry/outpost/centcomm17)
"MW" = (/obj/structure/bed/chair{dir = 4},/turf/simulated/floor/tiled/mono,/area/shuttle/ferry/outpost/centcomm17)
"ND" = (/turf/unsimulated/wall{icon_state = "riveted_l"; dir = 8},/area/shuttle/ferry/outpost/centcomm17)
"Op" = (/obj/structure/bed/chair{icon_state = "chair_preview"; dir = 1},/turf/simulated/floor/tiled/rough,/area/shuttle/ferry/outpost/centcomm17)
"OG" = (/turf/unsimulated/wall{icon_state = "riveted_straight"},/area/centcom/holding)
"OJ" = (/obj/effect/landmark/start/crew/detective,/turf/simulated/floor/shuttle/yellow,/area/shuttle/ferry/outpost/centcomm17)
"OM" = (/obj/machinery/light{dir = 8},/turf/simulated/floor/tiled/freezer,/area/shuttle/ferry/outpost/centcomm17)
"Pz" = (/obj/structure/window_frame/indestructible/hull,/turf/unsimulated/floor{name = "plating"},/area/shuttle/ferry/outpost/centcomm17)
"PA" = (/obj/structure/bed/chair{icon_state = "chair_preview"; dir = 1},/obj/effect/landmark/start/crew/rd,/turf/simulated/floor/shuttle/yellow,/area/shuttle/ferry/outpost/centcomm17)
"PD" = (/turf/simulated/floor/plating/rough,/turf/simulated/shuttle/wall/corner/smoothwhite/nw,/area/shuttle/ferry/outpost/centcomm17)
"Qj" = (/obj/structure/sign/flag/nt,/turf/unsimulated/wall{icon_state = "riveted_straight"; dir = 4},/area/shuttle/ferry/outpost/centcomm17)
"Qq" = (/turf/unsimulated/wall{icon_state = "riveted"},/area/shuttle/ferry/outpost/centcomm17)
"Qx" = (/turf/simulated/shuttle/wall{icon_state = "whiteship_straight"; dir = 4},/area/shuttle/ferry/outpost/centcomm17)
"QL" = (/obj/machinery/door/airlock/external{name = "Arrivals Airlock"; icon_state = "door_locked"; frequency = 1380; locked = 1; req_access = list(13); id_tag = "centcom_dock_airlock"},/turf/simulated/floor/tiled/rough,/area/shuttle/ferry/outpost/centcomm17)
"Rn" = (/turf/simulated/floor/plating/rough,/area/shuttle/ferry/outpost/centcomm17)
"RK" = (/obj/machinery/door/blast/regular{name = "Security Blast Door"; icon_state = "pdoor0"; opacity = 0; density = 0; id = "Prison Gate"},/obj/effect/landmark/start/crew/virologist,/turf/simulated/floor/shuttle/yellow,/area/shuttle/ferry/outpost/centcomm17)
"RS" = (/turf/unsimulated/wall,/area/shuttle/ferry/outpost/centcomm17)
"RT" = (/obj/machinery/power/apc{name = "east bump"; dir = 4; pixel_x = 24},/turf/simulated/floor/tiled/freezer,/area/shuttle/ferry/outpost/centcomm17)
"Sy" = (/obj/effect/floor_decal/stairs,/obj/machinery/door/blast/regular{name = "Security Blast Door"; icon_state = "pdoor0"; opacity = 0; density = 0; id = "Prison Gate"},/obj/effect/landmark/joinlate/observer,/turf/simulated/floor/tiled/mono,/area/shuttle/ferry/outpost/centcomm17)
"SQ" = (/obj/machinery/door/airlock/glass_security{name = "Security Lobby"},/turf/simulated/floor/tiled/rough,/area/shuttle/ferry/outpost/centcomm17)
"SZ" = (/obj/structure/toilet{dir = 8},/obj/machinery/light/small{dir = 4},/obj/machinery/newscaster{layer = 3.3; pixel_y = -27},/obj/effect/landmark/start/crew/janitor,/turf/simulated/floor/tiled/freezer,/area/shuttle/ferry/outpost/centcomm17)
"Tm" = (/obj/machinery/disposal,/obj/structure/disposalpipe/trunk{dir = 8},/turf/simulated/floor/tiled/rough,/area/shuttle/ferry/outpost/centcomm17)
"Tz" = (/obj/effect/landmark/start/crew/doctor,/turf/simulated/floor/tiled/mono,/area/shuttle/ferry/outpost/centcomm17)
"TL" = (/turf/simulated/shuttle/wall{icon_state = "whiteship"; dir = 8},/area/shuttle/ferry/outpost/centcomm17)
"TP" = (/obj/machinery/door/airlock{name = "Unit 2"},/turf/simulated/floor/tiled/freezer,/area/shuttle/ferry/outpost/centcomm17)
"TQ" = (/obj/effect/floor_decal/industrial/warning,/turf/simulated/floor/tiled/mono,/area/shuttle/ferry/outpost/centcomm17)
"Ve" = (/obj/effect/floor_decal/corner/lime{dir = 9},/obj/structure/closet/emcloset/legacy,/turf/simulated/floor/tiled/rough,/area/shuttle/ferry/outpost/centcomm17)
"Vi" = (/obj/structure/disposalpipe/segment{icon_state = "pipe-c"; dir = 1},/turf/unsimulated/wall{icon_state = "riveted"; dir = 8},/area/shuttle/ferry/outpost/centcomm17)
"Vp" = (/obj/structure/table/reinforced,/obj/effect/floor_decal/corner/lime{dir = 6},/obj/machinery/light,/turf/simulated/floor/tiled/rough,/area/shuttle/ferry/outpost/centcomm17)
"Vs" = (/obj/structure/table/reinforced,/obj/effect/floor_decal/corner/lime{dir = 9},/obj/structure/sign/recruitment{pixel_y = 32},/turf/simulated/floor/tiled/rough,/area/shuttle/ferry/outpost/centcomm17)
"VR" = (/turf/unsimulated/wall{icon_state = "riveted_t"},/area/shuttle/ferry/outpost/centcomm17)
"We" = (/obj/structure/disposalpipe/segment{dir = 4},/obj/machinery/vending/cigarette,/turf/simulated/floor/tiled/rough,/area/shuttle/ferry/outpost/centcomm17)
"Wj" = (/obj/structure/window/reinforced{dir = 8; health = 1e+06},/obj/structure/flora/ausbushes/pointybush,/turf/simulated/floor/natural/grass{name = "artificial grass patch"},/area/shuttle/ferry/outpost/centcomm17)
"WN" = (/obj/effect/floor_decal/corner/lime{dir = 9},/turf/simulated/floor/tiled/rough,/area/shuttle/ferry/outpost/centcomm17)
"WU" = (/obj/structure/toilet{dir = 8},/obj/machinery/light/small{dir = 4},/obj/machinery/newscaster{layer = 3.3; pixel_y = -27},/obj/effect/landmark/start/crew/clown,/turf/simulated/floor/tiled/freezer,/area/shuttle/ferry/outpost/centcomm17)
"Xh" = (/obj/effect/floor_decal/industrial/warning{dir = 1},/turf/simulated/floor/tiled/rough,/area/shuttle/ferry/outpost/centcomm17)
"Xu" = (/turf/unsimulated/wall{icon_state = "riveted_straight"; dir = 4},/area/shuttle/ferry/outpost/centcomm17)
"XF" = (/obj/effect/floor_decal/industrial/warning,/turf/simulated/floor/tiled/rough,/area/shuttle/ferry/outpost/centcomm17)
"XU" = (/obj/structure/filingcabinet/chestdrawer,/obj/machinery/computer/guestpass{pixel_y = -26},/turf/simulated/floor/tiled/rough,/area/shuttle/ferry/outpost/centcomm17)
"YA" = (/obj/item/device/radio/intercom{pixel_y = 22},/turf/simulated/floor/tiled/rough,/area/shuttle/ferry/outpost/centcomm17)
"Zb" = (/turf/unsimulated/wall{icon_state = "riveted_l"; dir = 4},/area/shuttle/ferry/outpost/centcomm17)
"Zq" = (/obj/structure/window/reinforced{dir = 4},/obj/structure/flora/ausbushes/ppflowers,/turf/simulated/floor/natural/grass{name = "artificial grass patch"},/area/shuttle/ferry/outpost/centcomm17)
"ZP" = (/obj/structure/table/reinforced,/obj/structure/window/reinforced{dir = 4},/obj/item/material/ashtray/plastic,/obj/item/device/taperecorder{pixel_x = -1; pixel_y = 2},/obj/item/paper_bin{pixel_y = 5},/obj/item/pen/blue{pixel_x = -5; pixel_y = -1},/turf/simulated/floor/tiled/rough,/area/shuttle/ferry/outpost/centcomm17)

(1,1,1) = {"
eSeSeSeSeSeSeSeSeSeSeSQqQLpRQqeSeSeSeSeSeSeSeSeSeSeSeSeSeSeSeSeS
eSeSeSeSeSeSeSeSeSeSeSlILjLjlIeSeSeSeSeSeSeSeSeSeSeSeSeSeSeSeSeS
eSeSeSeSeSeSeSeSeSeSeSlILjLjlIeSeSeSeSeSeSeSeSeSeSeSeSeSeSeSeSeS
eSeSeSeSeSbCQjPzPzPzPzduQLQLduPzPzPzPzXuNDeSeSeSeSeSeSeSeSeSeSeS
eSeSeSeSeSlILjLjLjLjLjkfXhXhxYLjLjLjLjYAlIeSeSeSeSeSeSeSeSeSeSeS
eSeSeSeSbCZbLjOpOpOpOpLjLjLjLjOpOpOpOpLjLdeRXuXuXuXuXuNDeSeSeSeS
eSeSeSeSlIVeLjJRJRJRJRLjLjLjLjJRJRJRJRLjCilIdbdbHpkkSZlIeSeSeSeS
eSeSeSeSlIEYLjLjLjLjLjLjLjLjLjLjLjLjLjLjDNduOMwEbWEjXuhOeSeSeSeS
eSeSeSeSlIWNLjLjLjLjLjLjLjLjLjLjLjLjLjLjuXnQwEwEwETPWUlIeSeSeSeS
eSeSeSeSlIdtLjCkpBpBEemGqxWelcbIGJpBTmLjvKQqOMwERTEjXuhOeSeSeSeS
eSeSeSeSccXuXumdvVvVEjXuXuXuXuVixMvVEjXuXuhOqEqEwEJpvflIeSeSeSeS
eSeSeSeSlILjLjSQqFcYcWBCqOZqVsMWGUBaSQLjLjccXuXuXuXuXuZbeSeSeSeS
eSeSeSeSGRLjHsZPqFcYcYelEyhRBYcYGUBaCfHsLjGReSeSeSeSeSeSeSeSeSeS
eSeSeSeSlIIwjuCvqFcYcYelWjZqBYcYGUBarGLJBEQqeSeSeSeSeSeSeSeSeSeS
eSeSeSeSlILjXUQqqFcYcWVpyALFcuMWGUBaQqXULjlIeSeSeSeSeSeSeSeSeSeS
eSeSeSeSlISQEjZbpISyEjXuXuXuXumdaLpILdmdSQOGeSeSeSeSeSeSeSeSeSeS
eSeSeSeSlIAZnwcYcYcYyBcYcYcYcYyBGUcYcYpkwuLdXuXuXuXumdeSeSeSeSeS
eSeSeSeSGRLjnwcYKmKmcYcYcYHdHdcYGUcYcYpkLjLjLjkfLjLjGReSeSeSeSeS
eSeSeSeSQqHBIicYsUsUcYnanacYcYcYIQTzcYiPLjLjLjLjLjHBQqeSeSeSeSeS
EjXuXuXuVRXumdTQTQTQTQTQTQTQTQImzlzWTQRSXFXFXFXFXFXFLdXuXuXuXumd
oZRnRnRnRnRnPDTLlMlMlMwxjBPDTLfllDRKwxjBPDTLqcKDaGwxjBRnRnRnRnoZ
oZRnRnRnRnRndXkBDHCAuBtldXdXOJvlpGhKAndXdXKJKJKJKJKJdXRnRnRnRnoZ
oZRnRnRnRnRnbLzCPAffoezCbLbLpPodFcrIukbLbLjRqTnXlzzKbLRnRnRnRnoZ
oZRnRnRnRnRnlaQxQxQxQxQxiflaQxQxQxQxQxiflaQxQxQxQxQxifRnRnRnRnoZ
nMArArArArArArArArArArArArArArArArArArArArArArArArArArArArArArnM
EjXuXuXuXuXuXuXuXuXuXuXuXuXuXuXuXuXuXuXuXuXuXuXuXuXuXuXuXuXuXumd
"}
